XXXXX  
X.. XX 
XX   XX
X@ *  X
XXX * X
  XX  X
   XXXX 
