XXXXXXXXXX
X  *    .X
XX   *  .X
X@       X
XXXXXXXXXX
