 XXXXXXX    
XX  .. X    
X   XX X    
X      XXX  
X  X *   XXX
XXXXX *   @X
    XXX  XXX
      XXXX
