XXXXXXX 
X..   X 
X X*X XX
X *  * X
XX .@  X
 XXXXXXX
