XXXXXXXX
X@   XXX
XXXX*XXX
XX    .X
X. *. XX
XX  X XX
XX  * XX
XX  XXXX
XXXXXXXX
