           XXXXXXX
           X     X
XXXXXXXXXXXX    .X
X    X    *      X
X    X     X    .X
X          XXXXXXX
X    X*    X      
X @        X      
XXXXXXXXXXXX      
